ChristuxAnimation	KEYWORD1
UniversalLedStripAdapter	KEYWORD1
ClockPanel	KEYWORD1
Animator	KEYWORD1
Rainbow	KEYWORD1
Sunrise	KEYWORD1
UniColor	KEYWORD1
Off	KEYWORD1
Flag	KEYWORD1
Blink	KEYWORD1
Bounce	KEYWORD1
Comet	KEYWORD1
Theater	KEYWORD1
KnightRider	KEYWORD1
RainbowLamp	KEYWORD1
RainbowLampRandom	KEYWORD1
Fire	KEYWORD1
Glitter	KEYWORD1
Breathing	KEYWORD1
ClockPanelAnimator	KEYWORD1
add	KEYWORD2
addSeparator	KEYWORD2
nextAnimation	KEYWORD2
setAnimation	KEYWORD2
setSeparatorAnimation	KEYWORD2
getAnimation	KEYWORD2
setColor	KEYWORD2
getColor	KEYWORD2
animCount	KEYWORD2
handle	KEYWORD2
Begin	KEYWORD2
SetAllPixels	KEYWORD2
SetPixelColor	KEYWORD2
Show	KEYWORD2
reset KEYWORD2
GetSeparator	KEYWORD2
GetDigit KEYWORD2
SetPattern KEYWORD2
SetMask KEYWORD2